#########
# .o    #
#  o.   #
#      p#
#########
